40
9
1 0 0 0 0 0 0 0 0 0 0 0 0 0 0 0 0 0 0 0 0 0 0 0 0 0 0 0 0 1 1 0 0 0 0 0 0 0 0 1
2 0 0 0 0 0 0 0 0 0 0 0 0 0 0 0 0 0 0 0 0 0 0 0 0 0 0 1 1 2 2 0 0 0 0 0 0 0 0 2
2 0 0 0 0 0 0 0 0 0 0 0 0 0 0 0 0 0 0 0 0 0 0 0 0 1 1 2 2 2 2 0 0 0 0 0 0 0 0 2
3 1 0 0 0 0 0 0 0 0 0 0 0 0 0 1 0 0 0 0 0 0 0 0 1 2 2 2 2 3 3 0 0 0 0 0 0 0 0 3
3 2 0 0 0 0 0 0 0 0 0 0 0 0 1 2 0 0 0 0 0 0 1 1 2 2 2 3 3 3 3 0 0 0 0 0 0 0 0 3
3 2 0 0 0 0 1 0 0 0 0 0 0 1 2 2 0 0 0 0 0 1 2 2 2 3 3 3 3 3 3 10 0 0 0 0 0 0 0 3
3 3 1 1 1 1 3 6 3 1 1 1 1 2 2 3 6 6 3 1 1 2 2 2 3 3 3 3 3 3 3 1 1 3 6 6 6 6 3 3
3 2 2 2 2 2 2 3 2 2 2 2 2 2 2 2 3 3 2 2 2 2 3 3 3 3 3 3 3 3 3 2 2 2 3 7 7 7 3 3
3 3 3 3 3 3 3 3 3 3 3 3 3 3 3 3 3 3 3 3 3 3 3 3 3 3 3 3 3 3 3 3 3 3 3 3 3 3 3 3 

