34
10
1 0 0 0 0 0 0 0 0 0 0 0 0 0 0 0 0 0 0 1 1 0 0 0 0 0 0 0 0 0 0  0 0 1
2 0 0 0 0 0 0 0 0 0 0 0 0 0 0 0 0 0 1 2 2 1 0 0 0 0 0 0 0 0 10 0 0 2
2 0 0 0 0 0 1 1 1 1 1 1 1 5 5 5 1 1 2 2 2 2 1 1 0 0 1 1 1 1 1  1 1 2
3 6 3 1 1 1 2 2 2 2 2 2 2 4 4 4 2 2 2 2 2 2 2 2 1 1 2 2 2 2 2  2 2 3
3 3 2 2 2 2 2 2 2 2 2 2 2 2 2 2 2 2 2 2 2 2 2 2 2 2 2 2 2 2 2  2 2 3